    0
    |
0 - 111111111111111111111111111111111111111111111111111111111111111111
    1E01000000PC100000000000000000000000000000000000000000000000000001
    1E0001111100100000000000000000000000000000000000000000000000000001
    1E0011E00000100000000000000000000000000000000000000000000000000001
    10000000000000000000000000C000C0000C000C0000C0000000000C0000000001
    100000000000000000000000000000000000000000000000000000000000000001
    100000000000000000000000000000000000000000000000000000000000000001
    100000000000000000000000000000000000000000000000000000000000000001
    100000000000000000000000000000000000000000000000000000000000000001
    100000000000000000000000000000000000000000000000000000000000000001
    100000000000000000000000000000000000000000000000000000000000000001
    100000000000000000000000000000000000000000000000000000000000000001
    111111111111111111111111111111111111111111111111111111111111111111


     1
     |
0 - 111111111111111111111111111111111111111111111111111111111111111111
    1001000000PC100000000000000000000000000000000000000000000000000001
    100001111100100000000000000000000000000000000000000000000000000001
    100011E00000100000000000000000000000000000000000000000000000000001
    10000000000000000000000000C000C0000C000C0000C0000000000C0000000001
    100000000000000000000000000000000000000000000000000000000000000001
    100000000000000000000000000000000000000000000000000000000000000001
    100000000000000000000000000000000000000000000000000000000000000001
    100000000000000000000000000000000000000000000000000000000000000001
    100000000000000000000000000000000000000000000000000000000000000001
    100000000000000000000000000000000000000000000000000000000000000001
    100000000000000000000000000000000000000000000000000000000000000001
    111111111111111111111111111111111111111111111111111111111111111111

